WWWWWWWWWWWWWWWWWW
WY..V...........YW
W.RXRX.IIII.RXRX.W
W.I..I.C..C.I..I.W
W.I..I.C..C.I..I.W
W.RXRX.YYYY.RXRX.W
W..HHHHHHHHHHHH..W
W..F....CC....F..W
W......F..F......W
W..F...P......F..W
W.......CC....O..W
W........Q....Z..W
W.RXRX.YYYY.RXRX.W
W.I..I.C..C.I..I.W
W.I..I.C..C.I..I.W
W.RXRX.IIII.RXRX.W
W...Z........Z...W
WWWWWWWWWWWWWWWWWW