WWWWWWWWWWWWWWWWWW
WBB...Z........BBW
WBB.......Z....BBW
W...III....III...W
W...INI....INI...W
W...III....III...W
W.T..........Z...W
W................W
W..Z....NN.......W
WM......NN.......W
W................W
W................W
W...III....III...W
W...INI....INI...W
W...III.P..III...W
WBB........Z...BBW
WBB...Z........BBW
WWWWWWWWWWWWWWWWWW