WWWWWWWWWWWWWWWWWW
WBB............BBW
WBB............BBW
W...III....III...W
W...INI....INI...W
W...III....III...W
W................W
W................W
W.......NN.......W
WM......NN.......W
W................W
W................W
W...III....III...W
W...INI....INI...W
W...III.P..III...W
WBB............BBW
WBB............BBW
WWWWWWWWWWWWWWWWWW