WWWWWWWWWWWWWWWWWW
WWIIIIIIIIIIIIIIWW
WIGG..........GGIW
WIG............GIW
WI.BB........BB.IW
WI.BIII....IIIB.IW
WI..IG.B..B.GI..IW
WI..I........I.TIW
WI..I.B....B.I..IW
WIT.I.B....B.I..IW
WI..I........I..IW
WI..IG.B..B.GI..IW
WI.BIII....IIIB.IW
WI.BB........BB.IW
WIG.....P......GIW
WIGG..........GGIW
WWIIIIIIIIIIIIIIWW
WWWWWWWWWWWWWWWWWW